%%%%%%%%%%
%2  P   1%
%%%%%%%%%%
